0011011111
1011010000
1000010111
1111000011
0111111011
0000011011
0111111011
0000000011
0110111111
0110000000