0000000001
1111111101
1000000001
1011111111
1010000001
1000111101
1111000001
1000011111
1111011111
1000000000
