000000001
111111101
100000001
101111111
101000001
100011101
111100001
100001111
111101111
100000000
