0011000011
1011010000
1000011101
1111000001
0111111011
0000011011
0111111011
0000000011
0110111011
0110000000